#..###.#...#..#....##.#...#....#....#..#.#.##...##
#O#..#.##.#######.#.#.####.##.###...##.#..#.###...
#..#.#.##.#....##...#..#.####.####...#..#..#..#.#.
##..##.##.#..#...###.#.....#.....##.######....#..#
..#.##..########.#.#####...#..##.##.#.....##.###.#
#............###.....#####.#####....#..##..#.###..
###.##.####...#.##....#..#.#..#.##.####.##....####
#.#..#.##.#.#.######..#.##..#.####..#.#######..###
.###......#..#..#..####.###..#..#.#.##..#.......##
.####..###.#.##.#.#...#..#.#.##.##......#..####..#
..######.###..###..##.#..###..##.#..##.####...#..#
#..##..#.......###.#..###......#.#####..#.#...#...
.......##.##.#.....#....#.##.#.###..#.#.####..##.#
#####.#.#.##...###.##...##.#..#..##.##...#######..
...##..##.#.###..#.###.#.##.#..#..##.#.....#..####
.#.###.#..#...#.##...#..#.#..#.......##..#.##..##.
##..#..#.######.#####.#..###..##.###.####...#.....
....##.#.##..#...##.#.##.####..#.###....#...#..###
##...#.......#......#.....#.###...########.#####.#
###.#######.########.##.#.###.##...##..#.#.##..#.#
.##.#...###.##...#.##.#..#.....##....#.##......#.#
.##.#.....#....#..#.##.#.####.#.#.##..#.#####.##.#
...###.##.#.###.#.##.###...##..##.#.#......##.#..#
.#..##.#..##..##...#.....#..##.#..#..##..#.##.#.##
###....#...###.#...##.#####.#..#..##.#####..###.#.
.#.##.###.#..#.##.#.###..#..##.#####..........#.##
.####..##..#.#.##..#.....#...#.#..#####.##.##.##.#
...#.#...#..##..##...###.##.##..#..##.#.##.#...#.#
#..##.##..#.###.#.####.#.##.###.#.....#....#.#.###
##..#######..#..#.....##.....#..######.##..#..#...
.###..#......#..###.#.#.###..#.....#.##.###.#..###
#..##.#..########.###.###.##.##..#.#..###.#..#.##.
.#...####....#.......#...#.#.#####.#.#...###.....#
...#....#..#.#.##..#.###..##.##...##.###.####.##..
############.#.#####....#.#.....#.##......#.#.#.##
#..##..#....##..#....##.#.#..##.#....##.#.##..#.##
#....#.##.#.#.#.#.###.#..######.#.###.#.##.#..#...
##.#..#.#.#.##..##..##.#.....#..###.##...#.###.##.
.##.#...#.##.#...#.#.######..#.#..##.#.#.#.#.#####
#.#..###...#.##.##.##..##.#..#.O...#.#..##.....###
.###.#.#.#.####.##..#.....##..##...#..#.####....##
.###..##..#...#.....#..######..##.####...######..#
..#.#.#.#..##.#.##.#####..#.##.##.##.#....#...#...
#.##..#..#.#..##.#.##..#..####.##...#####.#...#.##
.#.#.###...#...##......###..##....#.##..####..#..#
.#.#.####.###.#.#####.#...#....##.#.......####.#..
.#....###..##......##..##...###.#.#.##..#.##.####.
###.#..#.#...##..#.###.#.##.#.##..##.###...#...#.#
#.#.#..##.##.#####..#..##.#.##.#...#.#.#...##..##.
##..##..####.##.....##..##...####.##.#.##.#.#.#.#.
